11111111111
10000000001
10000E00001
10000000001
10000000PP1
11111111111