111111111111
1111111P1111
110000000001
10000CE00001
111111111111